.........
.#######.
.#.....#.
.###...#.
...#...#.
...#...#.
.###.###.
.#...#...
.##..###.
..#....#.
..######.
.........
